###############
#@            #
#   X    %    #
#   C         #
#     %       #
#   C    C    #
#             #
#   &    %    #
#             #
###############