###############
#@   C  %     #
#  X          #
#   C   %     #
#             #
#     &       #
#             #
#    C   %    #
#             #
###############